 1 1 1 1   1 1 1 1 1 1 1  1 1 1 1 1 1 1  1 1 1 1 1 1 1   1 1 1 1
 1 1 1 1   1 1 1 1 1 1 1  1 1 1 1 1 1 1  1 1 1 1 1 1 1   1 1 1 1
 1 1 1 1   1 1 1 1 1 1 1  1 1 1 1 1 1 1  1 1 1 1 1 1 1   1 1 1 1
 1 1 1 1   1 1 1 1 1 1 1  1 1 1 1 1 1 1  1 1 1 1 1 1 1   1 1 1 1
 1 1 1 1   1 1 1 1 1 1 1  1 1 1 1 1 1 1  1 1 1 1 1 1 1   1 1 1 1
 1 1 1 1   1 1 1 1 1 1 1  1 1 1 1 1 1 1  1 1 1 1 1 1 1   1 1 1 1
 1 1 1 1   1 1 1 1 1 1 1  1 1 1 1 1 1 1  1 1 1 1 1 1 1   1 1 1 1
 1 1 1 1   11 11 11 11 11 11 11  11 11 11 11 11 11 11  11 11 11 11 11 11 11   1 1 1 1

 1 1 1 1   11 0 0 0 0 0 0  0 0 0 0 0 0 0  0 0 0 0 0 0 11   1 1 1 1
 1 1 1 1   11 0 2 0 0 0 0  0 0 0 0 0 0 21  0 0 0 0 0 0 11   1 1 1 1
 1 1 1 1   11 0 0 0 0 0 0  0 0 0 0 0 0 0  0 0 0 0 0 0 11   1 1 1 1
 1 1 1 1   11 0 0 0 0 0 0  0 0 0 0 0 0 0  0 0 0 0 0 0 11   1 1 1 1
 1 1 1 1   11 0 0 0 0 0 0  0 0 0 0 0 0 0  0 0 0 0 0 0 11   1 1 1 1
 1 1 1 1   11 0 2 0 0 0 0  0 0 0 0 0 0 0  0 0 0 0 0 0 11   1 1 1 1
 1 1 1 1   11 0 0 0 0 0 0  0 0 0 0 0 0 0  0 0 0 0 0 0 11   1 1 1 1
 1 1 1 1   11 0 0 0 0 0 0  0 0 0 21 0 0 0  0 0 0 0 0 0 11   1 1 1 1
 1 1 1 1   11 0 0 0 0 0 0  0 0 0 0 0 0 0  0 0 0 0 0 0 11   1 1 1 1
 1 1 1 1   11 0 0 0 0 0 0  0 22 0 0 0 0 0  0 0 0 0 0 0 11   1 1 1 1
 1 1 1 1   11 0 0 0 0 0 0  0 0 0 0 0 0 0  0 0 0 21 0 0 11   1 1 1 1
 1 1 1 1   11 0 0 0 0 0 0  0 0 0 0 0 0 0  0 0 0 0 0 0 11   1 1 1 1
 1 1 1 1   11 0 0 0 0 0 0  0 0 0 0 0 0 0  0 0 0 0 0 0 11   1 1 1 1
 1 1 1 1   11 0 0 0 0 0 0  0 0 0 0 0 0 0  0 0 0 0 0 0 11   1 1 1 1

 1 1 1 1   11 0 0 0 0 0 0  0 0 0 0 0 0 0  0 0 0 0 2 0 11   1 1 1 1
 1 1 1 1   11 0 0 0 0 0 0  0 0 0 0 0 0 0  0 0 0 0 0 0 11   1 1 1 1
 1 1 1 1   11 0 0 0 0 0 0  0 0 0 0 0 0 0  0 0 0 0 0 0 11   1 1 1 1
 1 1 1 1   11 0 0 0 0 0 0  0 0 0 0 0 0 0  0 0 0 0 0 0 11   1 1 1 1
 1 1 1 1   11 0 21 0 0 0 0  0 0 0 0 0 0 0  0 0 0 0 0 0 11   1 1 1 1
 1 1 1 1   11 0 0 0 0 0 0  0 0 0 0 0 0 0  0 0 0 0 0 0 11   1 1 1 1
 1 1 1 1   11 0 0 0 0 0 0  0 0 0 0 0 0 0  0 0 0 0 0 0 11   1 1 1 1
 1 1 1 1   11 0 0 0 0 0 0  0 0 0 0 0 0 0  0 0 2 0 0 0 11   1 1 1 1
 1 1 1 1   11 0 0 0 0 0 0  0 0 0 0 0 0 0  0 0 0 0 0 0 11   1 1 1 1
 1 1 1 1   11 0 0 0 0 0 0  0 0 0 0 0 0 0  0 0 0 0 0 0 11   1 1 1 1
 1 1 1 1   11 0 0 0 0 0 0  0 0 0 0 0 0 0  0 0 0 0 0 0 11   1 1 1 1
 1 1 1 1   11 0 0 0 0 0 0  0 21 0 0 0 0 0  0 0 0 0 0 0 11   1 1 1 1
 1 1 1 1   11 0 0 0 0 0 0  0 0 0 0 0 0 0  0 0 0 0 0 0 11   1 1 1 1
 1 1 1 1   11 0 0 0 0 0 0  0 0 0 0 0 0 0  0 0 0 0 0 0 11   1 1 1 1

 1 1 1 1   11 11 11 11 11 11 11  11 11 11 11 11 11 11   11 11 11 11 11 11 11   1 1 1 1
 1 1 1 1   1 1 1 1 1 1 1  1 1 1 1 1 1 1   1 1 1 1 1 1 1   1 1 1 1
 1 1 1 1   1 1 1 1 1 1 1  1 1 1 1 1 1 1   1 1 1 1 1 1 1   1 1 1 1
 1 1 1 1   1 1 1 1 1 1 1  1 1 1 1 1 1 1   1 1 1 1 1 1 1   1 1 1 1
 1 1 1 1   1 1 1 1 1 1 1  1 1 1 1 1 1 1   1 1 1 1 1 1 1   1 1 1 1
 1 1 1 1   1 1 1 1 1 1 1  1 1 1 1 1 1 1   1 1 1 1 1 1 1   1 1 1 1
 1 1 1 1   1 1 1 1 1 1 1  1 1 1 1 1 1 1   1 1 1 1 1 1 1   1 1 1 1
 1 1 1 1   1 1 1 1 1 1 1  1 1 1 1 1 1 1   1 1 1 1 1 1 1   1 1 1 1
